房间号 房间类型   状态
001     大       空闲
002     中       空闲
003     小       空闲
004     大       空闲
005     小       空闲
006     小       空闲
007     中       占用
009     中       空闲
010     大       占用  
